{
  "ceilColor": "#04445C",
  "floorColor": "#008080",
  "layout": [
    "......",
    "......",
    "IHJ...",
    ".GEF..",
    "..D...",
    ".CAB.."
  ],
  "rooms": {
    "A": [
      "#######.#######",
      "####0##L##O####",
      "##...........##",
      "##...........##",
      "n#...........##",
      "...............",
      "##...........##",
      "#O.....@.....n#",
      "##...........##",
      "###############",
      "###############"
    ],
    "B": [
      "###############",
      "###############",
      "##...........##",
      "##..##.......##",
      "##..#G...##..##",
      "....0#.K.##..##",
      "##..##...G#..##",
      "##.......##..##",
      "##...........##",
      "###############",
      "###############"
    ],
    "C": [
      "###############",
      "###############",
      "##...........##",
      "##.b.........##",
      "##...........##",
      "##.K..b........",
      "##...........##",
      "##.b.........##",
      "##...........##",
      "###############",
      "###############"
    ],
    "D": [
      "#######.#######",
      "#######.#######",
      "##...........##",
      "##...........##",
      "##....###....##",
      "##....###....##",
      "##....###....##",
      "##...........##",
      "##...........##",
      "#######.#######",
      "#######.#######"
    ],
    "E": [
      "###############",
      "###############",
      "##...........##",
      "##...........##",
      "##..#.....#..##",
      ".......K.......",
      "##..#.....#..##",
      "##...........##",
      "##...........##",
      "#######.#######",
      "#######.#######"
    ],
    "F": [
      "###############",
      "###############",
      "##...........##",
      "##..#.....#..##",
      "##...........##",
      ".............##",
      "##...........##",
      "##..#.....#..##",
      "##...........##",
      "###############",
      "###############"
    ],
    "G": [
      "#######.#######",
      "#######L#######",
      "##...........##",
      "##...........##",
      "##....###....##",
      "##....###......",
      "##....###....##",
      "##...........##",
      "##...........##",
      "###############",
      "###############"
    ],
    "H": [
      "###############",
      "###############",
      "##...........##",
      "##...........##",
      "##...........##",
      ".......#.......",
      "##...........##",
      "##...........##",
      "##...........##",
      "#######.#######",
      "#######.#######"
    ],
    "I": [
      "###############",
      "###############",
      "##...........##",
      "##...........##",
      "##...........##",
      "##.............",
      "##...........##",
      "##...........##",
      "##...........##",
      "###############",
      "###############"
    ],
    "J": [
      "#######.#######",
      "#######.#######",
      "##...........##",
      "##.##.....##.##",
      "##...........##",
      ".......#.....L.",
      "##...........##",
      "##.##.....##.##",
      "##...........##",
      "###############",
      "###############"
    ]
  }
}
